
########################################################################################
#.....................##.......##..........................###.........P...............#
#............#######..##..##............###................###........##...............#
#............##....#..##..##............###.......P....P...###.......####........P.....#
#............##..H........##......P.....###.........................######.............#
#xxxx.o...|..##...........##B...........###...xx....xx...xx.....c..########.......|....G
########################################################################################
