###############################################################
##...######.....P......###.........##..........................
##...######............###....P...........P....................
##...######...####.....###.........c...........................
##...######...####.....###..####..####..####......c....P.......
##............####..........##     ## ....##...................
##o......c....####.|....P...##..|.....|...##.....|..|.....|...G
###############################################################
